

R 1920 1080


NO ./textures/redbrick.xpm
SO ./textures/mossy.xpm


WE ./textures/colorstone.xpm




EA ./textures/mur.xpm


S ./textures/police.xpm
M ./textures/policekid.xpm
U ./textures/pillar.xpm
F 128,128,128



C 119,181,255

1111111111111111111111111
1000000000110000000000401
1011003001110000002000001
10010000000000000000000001
151111111011000001110000100000001
100000000011000001110115111111111
11110111111111011100000012021
11110111111111011101010010001
11000000110101011100000000001
10002000000000001100000010001
10000000000000001101010010001
11400001110101011111011110N0111
11110111 1110101 101111110001
11111111 1111111 111111111111